WWWWWWWWWWWWWWW
WP    RBB BBBBW
W W W W W W W W
W         B B W
WBW B W B WBW W
W       R  B  W
W W Y W B R W W
WB   B   B    W
WBW W W WBW W W
W    YBB   B BW
W WBW W W W W W
WY       B   GW
WWWWWWWWWWWWWWW