WWWWWWWWWWWWWWW
WP    BBB BBBBW
W W W W W W W W
W         B B W
WBW W W W WBW W
W       R  B  W
W W W W W W W W
WB   B   B    W
WBW W W WBW W W
W    YBR   B BW
W WBW W W W W W
W       RB   GW
WWWWWWWWWWWWWWW